++++++++++++++++++++++++++++
+$                         +
+                          +
+     $^       @        $  +
+        $                 +
+   +++++++++              +
+                 ^     +  +
+     $   $             +  +
+                 @     +  +
+   ^                   +  +
+  ^    +  ^     ^      +  +
+       +               +  +
+    @  +++++++++       +  +
+       +               +  +
+   ^   +          ^       +
+                  ^       +
+  +  $    ^         ^     +
+  +           +       ^   +
+  +~~~~~~~    +           +
+  +++~~~~~++ +++++       ^+
+~    $        +           +
++++++++++++++++++++++++++++
