+++++++++++++++++++++++++++++
+      $     $     $     $  +
+   $     $     $     $     +
+$     $     $     $     $  +
+   $     $    $    $     $ +
+    $     $    $     $    $+
+     $   $   $    $    $   +
+ $    $     $      $      $+
+    $    $     $       $   +
+ $     $    $      $    $  +
+   $     $     $      $    +
+   $  $     $    $      $  +
+     $   $  $   $   $  $   +
+ $  $  $   $   $  $   $  $ +
+++++++++++++++++++++++++++++
