++++++++++++++++++++++++++++++
^^^^^^                ^^^^^^^^
^^^        + +~~~       ^^^^^^
^^        ~~ ~~~~~~      ^^^^^
^        ~~~ ~~~~~~~~       ^^
^     ~~~~~+ +~~~~~~~~~      ^
^   ~~~~~~~~ ~~~~~~~~~~~     ^
^  ~~~~~~~~~ ~~~~~~~~~~      ^
^  ~~~~~~~~+$+~~~~~~~~~~     ^
^  ~~~~~~~~~ ~~~~~~~~~~~     ^
^   ~~~~~~~~ ~~~~~~~~~~      ^
^    ~~~~~~+ +~~~~~~~       ^^
^      ~~~~~ ~~~~~         ^^^
^^       ~~~ ~~~~        ^^^^^
^^^^                    ^^^^^^
^^^^^^                ^^^^^^^^
^^^^^^^^^^^^^^^^^^^^^^^^^^^^^^
