+++++++++++++++++++++++++++++++++
+@             ^               @+
+              ^                +
+      $       ^        $       +
+              ^                +
+              ^                +
+                               +
+^^^^^^^^^^^^^ + ^^^^^^^^^^^^^^^+
+                               +
+              ^                +
+              ^                +
+      $       ^        $       +
+              ^                +
+              ^                +
+@             ^               @+
+++++++++++++++++++++++++++++++++
