++++++++++++++++++++++++++++++++
+                              +
+                              +
+^    ^^^            ^   ^$  ^ +
+^^        ^     ^             +
+    ~~~            ^          +
+   ~~~~~  ^ ^            ^    +
+   ~~~~~  ^^^                 +
+    ~~~$  ^^       ^^^        +
+       ^^^^^   ^  $~~~~  ^    +
+^    ^^^^         ~~~~~~   ^  +
+ ^^  ^^^          ~~~~~~  ^   +
+^           ^ ^^   ~~~~   ^   +
+            ^  $         ^    +
++++++++++++++++++++++++++++++++
