+++^^^^^^^^^^^^^^^^^^^^^^^^^^
^^^^^$    ^^^^^       ^^ ^ ^^
^^             ^^^   ^^^ ^^^^
^^^ ^^^ ^^  ^^^^^^       ^^^^
^^  ^^^ ^^          ^^^^^ ^^^
^^^  ^^ ^^ ^^^^^        ^^ ^^
^^^    ^^^ ^^^^^^^ ^      $^^
^^ ^       $^^^ ^^ ^^^^ ^^ ^^
^^^^    ^^^^ ^ ^^^ ^^^^^   ^^
^~~^^  ^^^^^^^^^^         ^^^
^~~^^   ^^^^^^^^^  ^^^^^   ^^
^^^^      ^^^^       ^^  ^^^^
^^^                     ^^^^^
^^    ^^^     ^  ^^^^^^^^~~~~
^^ ^^^ ^^^$^^^ ^^~~~~~~~~~~~~
^^^^^^^^^^^^^^^^~~~~~~~~~~~~~
