++++++++++++++++++++++++++++++++
+           ~~~                +
+   + +      ~~~  ^      +++   +
+   +$+       ~~~     ^  +$+   +
+   +++  ^               + +   +
+  ^          ~~~              +
+              ~~~~   +++      +
+    +++  ^     ~~~   +$       +
+ ^   $+       ~~~    +++   ^  +
+    +++      ~~~              +
+         ^   ~~~ ^            +
++ +          ~~~       + +    +
++$+   ^                +$+    +
++++          ~~~    ^  +++    +
+        ^     ~~~             +
++++++++++++++++++++++++++++++++
