++++++++++++++++++++
+$   +        +   $+
+ ++ + ++++++ + ++ +
+ +              + +
+ + ++ ++  ++ ++ + +
+      +    +      +
+ + ++ ++++++ ++ + +
+ +              + +
+ ++ + ++++++ + ++ +
+$   +        +   $+
+++@ ++++++++++ @+++
+$   +        +   $+
+ ++ + ++++++ + ++ +
+ +              + +
+ + ++ ++++++ ++ + +
+      +    +      +
+ + ++ ++  ++ ++ + +
+ +              + +
+ ++ + ++++++ + ++ +
+$   +        +   $+
++++++++++++++++++++
