++++++++++++++++++++++
+                    +
+ $                $ +
+  +++++      +++++  +
+  +              +  +
+  + $          $ +  +
+  +  +  ++++  +  +  +
+  +              +  +
+       $    $       +
+     +  +  +  +     +
+     +        +     +
+     +        +     +
+     +  +  +  +     +
+       $    $       +
+  +              +  +
+  +  +  ++++  +  +  +
+  + $          $ +  +
+  +              +  +
+  +++++      +++++  +
+ $                $ +
+                    +
++++++++++++++++++++++
