++++++++++++++++++++++
+                    +
+ $                $ +
+  +++++      +++++  +
+  +              +  +
+  +              +  +
+  +  +  ++++  +  +  +
+  +              +  +
+                    +
+     +  +  +  +     +
+     +        +     +
+     +        +     +
+     +  +  +  +     +
+                    +
+  +              +  +
+  +  +  ++++  +  +  +
+  +              +  +
+  +              +  +
+  +++++      +++++  +
+ $                $ +
+                    +
++++++++++++++++++++++
