++++++++++++++++++++++++
+           ~$$$$$$$$$$+
+           ~$$$$$$$$$$+
+    +      ~$$$$$$$$$$+
+   +@+  $  ~$$$$$$$$$$+
+    +      ~$$$$$$$$$$+
+           ~$$$$$@$$$$+
+           ~$$$$$$$$$$+
+    @      ~$$$$$$$$$$+
+           ~$$$$$$$$$$+
+           ~$$$$$$$$$$+
++++++++++++++++++++++++
