++++++++++++++++++++++
+@ @ @ @ @ @ @ @ @ @ +
+ @ @ @ @ @ @ @ @ @ @+
+@ @ @ @ @ @ @ @ @ @ +
+ @ @ @ @ @ @ @ @ @ @+
+@ @ @ @ @ @ @ @ @ @ +
+ @ @ @ @ @ @ @ @ @ @+
+@ @ @ @ @$@ @ @ @ @ +
+ @ @ @ @ @ @ @ @ @ @+
+@ @ @ @ @ @ @ @ @ @ +
+ @ @ @ @ @ @ @ @ @ @+
+@ @ @ @ @ @ @ @ @ @ +
+ @ @ @ @ @ @ @ @ @ @+
+@ @ @ @ @ @ @ @ @ @ +
+ @ @ @ @ @ @ @ @ @ @+
++++++++++++++++++++++
