++++++++++++++++++++++++++++++++++++
+                                  +
+                                  +
+    ++++++++++++++++++++++++++    +
+         $                        +
+                 $        $       +
+    ++++++++++++++++++++++++++    +
+               $                  +
+         $           $            +
+    ++++++++++++++++++++++++++    +
+        $               $         +
+                  $               +
+    ++++++++++++++++++++++++++    +
+          $                       +
+                    $             +
+    ++++++++++++++++++++++++++    +
+               $                  +
+        $               $         +
+    ++++++++++++++++++++++++++    +
+                                  +
+                                  +
++++++++++++++++++++++++++++++++++++
