++++++++++++++++++++++++++++
+$                         +
+                          +
+     $        @        $  +
+        $                 +
+   +++++++++              +
+                       +  +
+     $   $             +  +
+                 @     +$ +
+   ^                   +  +
+  ^    +  &            +  +
+       +               +  +
+    @  +++++++++       +  +
+       +               +  +
+   ^   +          ^       +
+                  ^       +
+  +  $    ^         ^     +
+  +           +       &   +
+ $+           +           +
+  +++~~~~~++ +++++        +
+~    $        +           +
++++++++++++++++++++++++++++
