++++++++++++++++++++++++++++
+$                         +
+                          +
+     $#       @        $  +
+        $                 +
+   +++++++++              +
+                 #     +  +
+     $   $             +  +
+                 @     +$ +
+   ^                   +  +
+  ^    +  &     #      +  +
+       +               +  +
+    @  +++++++++       +  +
+       +               +  +
+   ^   +          ^       +
+                  ^       +
+  +  $    ^         ^     +
+  +           +       &   +
+ $+     #     +           +
+  +++~~~~~++ +++++       #+
+~    $        +           +
++++++++++++++++++++++++++++
