++++++++++++++++++++++++++++
+$                         +
+                          +
+     $#       @        $  +
+        $                 +
+   +++++++++              +
+                 #     +  +
+     $   $             +  +
+                 @     +  +
+   *                   +  +
+  *    +  &     #      +  +
+       +               +  +
+    @  +++++++++       +  +
+       +               +  +
+   *   +          *       +
+                  *       +
+  +  $    *         *     +
+  +           +       &   +
+  +     #     +           +
+  +++~~~~~++ +++++       #+
+~             +           +
++++++++++++++++++++++++++++
