++++++++++++++++++++++++++++++++++++++++
+                                      +
+                                      +
+        $                 $           +
+                                      +
+      +++++++++                       +
+                          +           +
+        $                 +           +
+                    @     +           +
+                          +           +
+          +  &            +           +
+          +               +           +
+       @  +++++++++       +           +
+          +               +           +
+          +                           +
+                                      +
+     +  $                             +
+     +           +       &            +
+     +           +                    +
+     +++~~~~~++++++++                 +
+                 +                    +
++++++++++++++++++++++++++++++++++++++++
