++++++++++ ++ ++  +++++++
+$
+                          +
+     $        @        $  +
+        $                 +
+   +++++++++              +
+                       +  +
+     $   $             +  +
+                 @     +$ +
+   ^                   +  +
+  ^    +               +  +
+       +               +  +
+    @  +++++++++       +  +
+       +               +  +
+   ^   +          ^       +
+                  ^       +
+  +  $    ^         ^     +
+  +           +           +
+ $+           +           +
+  +++~~~~~++ +++++        +
+~    $        +           +
++++++++++++++++++++++++++++
