++++++++++++++++++++++++++++
+$                         +
+                          +
+     $#       @        $  +
+        $                 +
+   +++++++++              +
+                 #     +  +
+     $   $             +  +
+                 @     +$ +
+   *                   +  +
+  *    +  &     #      +  +
+       +               +  +
+    @  +++++++++       +  +
+       +               +  +
+   *   +          *       +
+                  *       +
+  +  $    *         *     +
+  +           +       &   +
+ $+     #     +           +
+  +++~~~~~++ +++++       #+
+~    $        +           +
++++++++++++++++++++++++++++
