++++++++++++++++++++++++++++++++++++++++
+$                                     +
+                                      +
+        $                 $           +
+                                      +
+      +++++++++                       +
+                          +           +
+        $                 +           +
+                    @     +           +
+      *                   +           +
+     *    +  &            +           +
+          +               +           +
+   *   @  +++++++++       +           +
+          +               +           +
+          +          *                +
+                     *                +
+     +  $    *         *       *      +
+     +           +       &            +
+     +           +                    +
+     +++~~~~~++++++++          *      +
+~                +                    +
++++++++++++++++++++++++++++++++++++++++
