+++++++++++++++++++++++++
+$ +  +  +$ +  +   +  $@+
++  +  +  +  +  +  +  + +
+@+     ~  ~    ~  ~    ~
+  +        ^    +    ++~
~+   ~~~~   ^  +   +    +
+                       ^
+~^~+~+~+^+~+~+^+~+~ ^+~+
~$$$^^    ~~$^     ^    ^
~$ ^   ~        ^       ~
~ ~ ~ ~ ~ ~ ~ ~ ~ ~ ~ ~ ~
+                       ~
~+ + + + + + + + + + + ++
~                     +^^
^^^^^^^^^^^^^^^^^^^^^^^^^
