~~~~~~~~~~~~~~~~~~~~~~~~
~$  ~~~               $~
~ ~      ^ ^^^^^^^^^^^ ~
~    ~~~ ^             ~
~ ^    ~ ^ ~~~~~~~~~ ^ ~
~ ^^^^ ~ ^ ~    ~~   ^ ~
~ ^    ~   +  ~    ~ ^ ~
~ ^ ~~~~~~+++~~~~~ ~ ^ ~
~ ^        +       ~ ^ ~
~ ^ ~~~~~~ ~ ~~~~~ ~ ^ ~
~ ^      ~ ~ ~         ~
~$  ~~~        ~~~~~~ $~
~~~~~~~~~~~~~~~~~~~~~~~~
