~~~~~~~~~~~~~~~~~~~~~~~~
~$  ~~~               $~
~ ~      ^ ^^^^^^^^^^^ ~
~    ~~~ ^             ~
~ ^    ~ ^ ~~~~~~~~~ ^ ~
~ ^^^^ ~ ^      ~~   ^ ~
~ ^    ~   +  ~    ~ ^ ~
~ ^ ~~~~~ +++ ~~~~ ~ ^ ~
~ ^        +       ~ ^ ~
~ ^ ~~~~~~ ~ ~~~~~ ~ ^ ~
~ ^      ~ ~ ~         ~
~$  ~~~        ~~~~~~ $~
~~~~~~~~~~~~~~~~~~~~~~~~
