+++++++++++++++++++++++++++++++++++
^       ^   ~  ~   ^^      ^^   ~$^
^    ^^ ^  ~       ^^   ~ ~~   ^^ ^
^   ~~~        ^^   ~ ~    ~      ^
^  ~      ~  ^^               ~   ^
^    ^          ~ ~~  ^^  ^^      ^
^  ~ ^      ^^          ^^  ~ ~   ^
^ ~  ^  ^^     ~  ^^    ~         ^
^    ^        ^^       ~    ^^  ~ ^
^   ~^   ~^^       ~^^   ~^^    ~ ^
^^    ~  ~             ~~     ~   ^
^^            ^^  ^^      ~~      ^
^$^  ^^  ^^    ^^  ^^^^           ^
^    ~~   ~^^  ^^^^    ~ ~~  ^^^^ ^
^^^             ~  ^^     ~  ~~   ^
^  ~ ^^  ^^^^  ~     ~   ~   ~    ^
^~  ~ ~ ~   ~    ~  ~   ~   ~   ~ ^
^       ~  ^^  ^^  ^^  ^^  ^^     ^
^  ~ ^^  ~    ~   ~ ~ ~~  ~  ~ ^^ ^
^  ~       ^^   ~      ^^         ^
^    ~ ^^     ~  ~ ^^     ~  ^^  ~^
^  ~       ^^          ^^        ~^
^    ^^  ^^^^  ^^  ^^^^     ~  ^^$^
^~~                      ^^       ^
^^^^^^^^^^^^^^^^^^^^^^^^^^^^^^^^^^^
