++++++++++++++++++++++++++++
+                          +
+    $      $        $     +
+                          +
+    ++                    +
+    +++                   +
+     +                    +
+               $          +
+                          +
+                          +
+    $     $               +
+                 +++      +
+       $         ++++     +
+                 +        +
^                          +
^^^^ ~~      $             +
^^^^~~~~                   +
^^^^~~~           $        +
^^^^^^      $              +
^^                         +
+                          +
++++++++++++++++++++++++++++
