
+                         +
+                                      +
+                                      +
+                                      +
+                                      +
+      +++++++++                       +
+                          +           +
+                          +           +
+                    @     +           +
+                          +           +
+          +               +           +
+          +               +           +
+       @  +++++++++       +           +
+          +               +           +
+          +                           +
+                                      +
+     +                                +
+     +           +                    +
+     +           +                    +
+     +++~~~~~++++++++                 +
+                 +                    +
+                 +                    +
+                 +                    +
+                              @       +
+                                      +
+    @                                 +
+                     ~~~~~~~          +
+                                      +
+                                      +
+                                      +
+       +                              +
+       +                              +
+       ++++++++                       +
+                                      +
+                                      +
+                                      +
+                                      +
++++++++++++++++++++++++++++++++++++++++
